a......3.1
....@.@.@.
.@@@.....b
.@2@.@@@@.
.@.@.@....
.@...@....
.....@....
......@...
..c.......
@@@@@@@@..
