a......3.1
....@.@.@.
.@@@...b.c
.@2@.@@@@.
.@.@.@....
.@...@....
.....@....
......@...
..........
@@@@@@@@..
